####################
#..................#
#..................#
#.........##.......#
#..................#
#..................#
#....##......E.....#
#....#........E....#
#............E.....#
#.....#....E..E....#
#..P..P#.....E.....#
#..P..P#......E....#
#..P..P......E.....#
#.....#............#
#..................#
#..................#
#.......###........#
#..................#
#..................#
####################
