###################
#.................#
#.................#
#.........##......#
#.................#
#.................#
#....##......E....#
#....#........E...#
#............E....#
#.....#....E..E...#
#.PP...#.....E....#
#.PP...#......E...#
#.PP.........E....#
#.....#...........#
#.................#
#.................#
#.......###.......#
#.................#
#.................#
###################